RowName,C0,C1,C2,C3,C4,C5,C6,C7,C8,C9
1,O,O,-,-,-,-,-,-,-,-
2,O,O,-,-,-,-,-,-,-,-
3,O,O,-,-,-,-,-,-,-,-
4,-,-,-,-,-,-,-,-,-,-
5,-,-,-,-,-,-,-,-,-,-
6,-,-,-,-,-,-,-,-,-,-
7,-,-,-,-,-,-,-,-,-,-
8,-,-,-,-,-,-,-,-,-,-
9,-,-,-,-,-,-,-,-,-,-
10,-,-,-,-,-,-,-,-,-,-
