RowName,C0,C1,C2,C3,C4,C5,C6,C7,C8,C9
01,X,O,O,O,X,-,-,-,-,-
02,X,O,O,O,O,-,-,-,-,-
03,O,O,O,O,X,-,-,-,-,-
04,X,X,O,O,X,-,-,-,-,-
05,-,-,-,-,-,-,-,-,-,-
06,-,-,-,-,-,-,-,-,-,-
07,-,-,-,-,-,-,-,-,-,-
08,-,-,-,-,-,-,-,-,-,-
09,-,-,-,-,-,-,-,-,-,-
10,-,-,-,-,-,-,-,-,-,-
